10
10
OOXXXXXXXX
XOXXXXXXXX
XOOOXXXXXX
XXXOOXXXXX
XXXXOOXXXX
XXXXXOXXXX
XXXXXOXXXX
XXXXXOOOOX
XXXXXXXXOO
XXXXXXXXXOZ
